##########
#* #    B#
# b#bb# ##
## #  # B#
#B       #
## #  # ##
##       #
##########